





















[
1,1,1,1,1,1,1,1,1,1,1,1,1,1,
1,2,2,1,2,1,2,2,2,2,2,2,2,1,
1,2,2,2,8,8,2,2,2,4,2,2,2,1,
1,2,2,9,9,8,9,9,9,9,2,2,2,1,
1,2,2,8,8,8,8,8,8,8,2,2,2,1,
1,2,2,2,2,2,2,2,2,2,2,2,2,1,
1,1,1,1,1,2,2,2,2,2,2,2,2,1,
1,2,2,2,2,2,2,2,2,2,2,2,2,1,
1,2,2,2,2,2,2,2,2,2,2,2,2,1,
1,2,2,2,2,2,2,2,2,2,2,2,2,1,
2,2,2,2,2,2,2,2,2,2,2,2,2,1,
2,2,2,2,2,2,2,2,2,2,2,2,2,1,
1,2,2,2,2,2,2,2,2,2,2,2,2,1,
1,0,0,0,0,0,0,0,0,0,0,0,3,1,
1,0,0,0,0,0,0,8,0,0,0,0,0,1,
1,1,1,1,1,1,1,1,1,1,1,1,1,1
]



[
0,0,0,0,0,0,0,0,0,1,1,1,1,1,
0,1,1,1,0,0,0,0,0,1,1,1,1,1,
0,0,0,0,1,1,0,1,1,1,1,1,1,1,
0,1,0,0,1,1,0,0,0,0,0,0,0,0,
0,1,1,0,0,3,0,1,1,1,1,1,1,1,
1,1,1,0,0,0,0,1,1,1,1,1,1,1,
1,1,1,1,1,0,0,0,0,0,0,0,0,0,
0,0,0,0,0,0,0,1,0,1,1,1,1,0,
1,0,0,1,1,0,0,1,1,1,1,1,1,1,
0,0,0,0,1,4,0,1,1,1,1,1,1,1,
1,1,1,1,1,0,1,1,1,1,1,1,1,1,
1,1,1,1,1,1,1,1,1,1,1,1,1,1,
1,1,1,1,1,1,1,1,1,1,1,1,1,1,
1,1,0,0,0,1,1,1,1,1,1,1,1,1,
1,1,0,1,0,1,1,1,1,1,1,1,1,1,
1,1,0,1,0,1,1,1,1,1,1,1,1,1
] 

[
0,0,0,0,0,0,0,0,0,1,1,1,1,1,
0,1,1,1,0,0,0,0,0,1,1,1,1,1,
0,0,0,0,1,1,0,1,1,1,1,1,1,1,
0,1,8,0,1,1,1,1,1,1,1,1,1,1,
0,1,1,0,0,3,0,1,1,1,1,1,1,1,
1,1,1,1,1,1,0,1,1,1,1,1,1,1,
0,0,1,1,1,1,0,0,0,0,0,0,0,0,
1,1,1,1,1,1,5,1,0,1,1,1,1,0,
1,1,1,1,1,0,0,1,1,1,1,1,1,1,
1,1,1,1,1,4,0,1,1,1,1,1,1,1,
1,1,1,1,1,0,1,1,1,1,1,1,1,1,
1,1,1,1,1,1,1,1,1,1,1,1,1,1,
1,1,1,1,1,1,1,1,1,1,1,1,1,1,
1,1,0,0,0,1,1,1,1,1,1,1,1,1,
1,1,0,1,0,1,1,1,1,1,1,1,1,1,
1,1,0,1,0,1,1,1,1,1,1,1,1,1
]
[
0,0,0,0,0,0,0,0,0,1,1,1,1,1,
0,1,1,1,0,0,0,0,0,1,1,1,1,1,
0,0,0,0,1,1,0,1,1,1,1,1,1,1,
0,1,8,0,1,1,1,1,1,1,1,1,1,1,
0,1,1,0,0,3,0,1,1,1,1,1,1,1,
1,1,1,1,1,1,0,1,1,1,1,1,1,1,
0,0,1,1,1,1,0,0,0,0,0,0,0,0,
1,1,1,1,1,1,5,1,0,1,1,1,1,0,
1,1,1,1,1,0,0,1,1,1,1,1,1,1,
1,1,1,1,1,4,0,1,1,1,1,1,1,1,
1,1,1,1,1,0,1,1,1,1,1,1,1,1,
1,1,1,1,1,1,1,1,1,1,1,1,1,1,
1,1,1,1,1,1,1,1,1,1,1,1,1,1,
1,1,0,0,0,1,1,1,1,1,1,1,1,1,
1,1,0,1,0,1,1,1,1,1,1,1,1,1,
1,1,0,1,0,1,1,1,1,1,1,1,1,1
]


