




































[
1,1,1,1,1,1,1,1,1,1,1,1,1,1,
1,1,0,1,1,1,1,1,0,0,0,1,0,1,
1,0,0,0,0,0,3,0,0,1,0,1,0,1,
1,0,1,0,1,1,1,1,1,1,0,1,0,1,
1,0,1,0,1,2,2,2,2,1,0,1,0,1,
1,0,1,0,1,2,2,2,2,1,0,0,0,1,
0,0,0,0,1,2,2,2,2,1,1,1,0,0,
1,0,1,0,0,9,9,0,8,1,0,0,0,1,
1,0,1,0,1,0,1,1,0,1,0,1,1,1,
1,0,1,0,1,2,1,1,2,1,0,0,0,1,
1,0,1,1,2,2,2,2,2,2,1,1,0,1,
1,0,1,1,2,2,2,2,2,2,1,0,0,1,
1,0,0,0,2,4,5,6,7,2,0,0,1,1,
0,0,1,1,2,2,2,2,2,2,1,0,0,0,
1,0,1,1,2,2,2,2,2,2,1,1,1,1,
1,1,1,1,1,1,1,1,1,1,1,1,1,1
]











[
1,1,1,1,1,1,1,1,1,1,1,1,1,1,
1,8,0,0,0,0,1,1,0,0,0,8,0,1,
1,0,1,0,1,0,1,1,0,1,0,1,0,1,
1,0,0,0,0,0,0,0,0,0,0,0,0,1,
1,0,1,0,0,1,2,2,1,0,1,1,0,1,
1,0,1,1,0,1,2,2,1,0,0,0,0,1,
1,0,1,0,0,1,2,2,1,1,0,1,0,1,
0,0,0,0,1,2,2,2,2,1,0,1,0,0,
1,0,1,0,0,2,4,5,2,0,0,0,0,1,
1,0,1,1,0,2,1,1,2,0,1,1,0,1,
1,0,0,0,0,0,3,0,0,0,0,0,0,1,
1,1,1,0,1,0,1,1,1,1,0,1,0,1,
1,0,0,0,1,0,0,0,1,0,8,1,0,1,
1,8,1,1,1,1,1,0,1,0,1,1,0,1,
1,0,0,0,0,0,0,0,0,0,0,0,0,1,
1,1,1,1,1,1,1,1,1,1,1,1,1,1
] 











[
2,0,0,0,0,0,0,8,0,0,0,0,0,2,
2,0,1,1,1,1,1,1,1,1,1,1,4,2,
2,0,0,0,0,0,8,0,0,0,0,1,0,2,
2,6,1,1,1,1,1,1,1,1,0,1,0,2,
2,0,1,0,0,0,0,0,0,1,0,0,0,2,
2,0,0,0,0,1,1,1,1,1,0,1,0,2,
2,0,1,0,0,0,0,0,0,0,0,1,0,2,
2,0,1,0,1,3,0,1,0,0,1,1,0,2,
2,0,1,0,1,1,1,1,1,0,1,9,0,2,
2,9,1,0,1,1,1,1,0,0,1,1,0,2,
2,0,1,0,0,0,8,0,0,0,0,1,0,2,
2,0,1,0,1,2,2,2,0,1,0,0,0,2,
2,0,0,0,1,2,2,2,0,1,0,1,0,2,
2,0,1,0,0,0,0,0,0,8,0,1,0,2,
2,5,1,1,1,1,0,1,1,1,1,1,4,2,
2,0,0,0,0,0,9,0,0,0,0,0,0,2
]



[
0,0,0,0,0,0,0,0,0,1,1,1,1,1,
0,1,1,1,0,0,0,0,0,0,0,0,1,1,
0,0,0,0,1,1,0,1,2,1,1,0,1,1,
0,1,8,0,1,1,1,1,2,1,1,0,1,1,
0,1,1,0,0,3,0,1,2,1,1,0,1,0,
1,1,1,1,1,1,0,1,2,1,1,0,0,0,
0,0,0,0,0,0,2,2,2,2,2,2,2,2,
1,1,0,1,1,1,5,1,2,1,2,1,1,2,
1,1,0,1,1,2,2,1,1,1,2,1,1,1,
1,1,0,1,1,4,2,1,1,1,2,1,1,1,
0,0,0,1,1,2,0,1,1,1,0,0,0,0,
1,1,0,1,1,1,0,1,1,1,0,1,1,1,
1,0,0,1,1,1,0,0,1,1,0,1,1,1,
0,0,0,1,1,1,0,0,1,1,0,1,1,1,
0,1,0,0,0,0,0,0,0,0,0,1,1,1,
0,0,0,0,1,1,1,1,1,1,1,1,1,1
]



